w	a	x	x	x	x	x	x	x	x	x	x	x	x	x	x	x	x	x	x	x	x	x	x	x	x	x	x	x	x	b	w
w	y	a	x	x	x	x	x	x	x	x	x	x	x	x	b	a	x	x	x	x	x	x	x	x	x	x	x	x	b	y	w
w	y	y	o	o	o	o	o	o	o	o	o	o	o	o	y	y	o	o	o	o	o	o	o	o	o	o	o	o	y	y	w
w	y	y	o	a	x	x	b	o	a	x	x	x	b	o	y	y	o	a	x	x	x	b	o	a	x	x	b	o	y	y	w
w	y	y	p	y	w	w	y	o	y	w	w	w	y	o	y	y	o	y	w	w	w	y	o	y	w	w	y	p	y	y	w
w	y	y	o	d	x	x	c	o	d	x	x	x	c	o	d	c	o	d	x	x	x	c	o	d	x	x	c	o	y	y	w
w	y	y	o	o	o	o	o	o	o	o	o	o	o	o	o	o	o	o	o	o	o	o	o	o	o	o	o	o	y	y	w
w	y	y	o	a	x	x	b	o	a	b	o	a	x	x	x	x	x	x	b	o	a	b	o	a	x	x	b	o	y	y	w
w	y	y	o	d	x	x	c	o	y	y	o	d	x	x	b	a	x	x	c	o	y	y	o	d	x	x	c	o	y	y	w
w	y	y	o	o	o	o	o	o	y	y	o	o	o	o	y	y	o	o	o	o	y	y	o	o	o	o	o	o	y	y	w
w	y	d	x	x	x	x	b	o	y	d	x	x	b	.	y	y	.	a	x	x	c	y	o	a	x	x	x	x	c	y	w
w	y	w	w	w	w	w	y	o	y	a	x	x	c	.	d	c	.	d	x	x	b	y	o	y	w	w	w	w	w	y	w
w	y	w	w	w	w	w	y	o	y	y	.	.	.	.	.	.	.	.	.	.	y	y	o	y	w	w	w	w	w	y	w
w	y	w	w	w	w	w	y	o	y	y	.	a	x	x	x	x	x	x	b	.	y	y	o	y	w	w	w	w	w	y	w
w	d	x	x	x	x	x	c	o	d	c	.	y	w	w	w	w	w	w	y	.	d	c	o	d	x	x	x	x	x	c	w
.	.	.	.	.	.	.	.	o	.	.	.	y	w	w	w	w	w	w	y	.	.	.	o	.	.	.	.	.	.	.	.
w	a	x	x	x	x	x	b	o	a	b	.	y	w	w	w	w	w	w	y	.	a	b	o	a	x	x	x	x	x	b	w
w	y	w	w	w	w	w	y	o	y	y	.	d	x	x	x	x	x	x	c	.	y	y	o	y	w	w	w	w	w	y	w
w	y	w	w	w	w	w	y	o	y	y	.	.	.	.	.	.	.	.	.	.	y	y	o	y	w	w	w	w	w	y	w
w	y	w	w	w	w	w	y	o	y	y	.	a	x	x	x	x	x	x	b	.	y	y	o	y	w	w	w	w	w	y	w
w	y	a	x	x	x	x	c	o	d	c	.	d	x	x	b	a	x	x	c	.	d	c	o	d	x	x	x	x	b	y	w
w	y	y	o	o	o	o	o	o	o	o	o	o	o	o	y	y	o	o	o	o	o	o	o	o	o	o	o	o	y	y	w
w	y	y	o	a	x	x	b	o	a	x	x	x	b	o	y	y	o	a	x	x	x	b	o	a	x	x	b	o	y	y	w
w	y	y	o	d	x	b	y	o	d	x	x	x	c	o	d	c	o	d	x	x	x	c	o	y	a	x	c	o	y	y	w
w	y	y	p	o	o	y	y	o	o	o	o	o	o	o	o	o	o	o	o	o	o	o	o	y	y	o	o	p	y	y	w
w	y	d	x	b	o	y	y	o	a	b	o	a	x	x	x	x	x	x	b	o	a	b	o	y	y	o	a	x	c	y	w
w	y	a	x	c	o	d	c	o	y	y	o	d	x	x	b	a	x	x	c	o	y	y	o	d	c	o	d	x	b	y	w
w	y	y	o	o	o	o	o	o	y	y	o	o	o	o	y	y	o	o	o	o	y	y	o	o	o	o	o	o	y	y	w
w	y	y	o	a	x	x	x	x	c	d	x	x	b	o	y	y	o	a	x	x	c	d	x	x	x	x	b	o	y	y	w
w	y	y	o	d	x	x	x	x	x	x	x	x	c	o	d	c	o	d	x	x	x	x	x	x	x	x	c	o	y	y	w
w	y	y	o	o	o	o	o	o	o	o	o	o	o	o	o	o	o	o	o	o	o	o	o	o	o	o	o	o	y	y	w
w	y	d	x	x	x	x	x	x	x	x	x	x	x	x	x	x	x	x	x	x	x	x	x	x	x	x	x	x	c	y	w
w	d	x	x	x	x	x	x	x	x	x	x	x	x	x	x	x	x	x	x	x	x	x	x	x	x	x	x	x	x	c	w
